  # ####### ##### ####### ######### ##### 
 #.#....,,,#..,,,#.......#....,,,,,#,,,,,#
 #.#.###,#,###,#,#####.#.#.###,###,#,###,#
 #.#.#,,,#,,,,,#,,,,,#.#.....#,#,,,#,,,#,#
 #.#.#,## ##########,#.#####.#,#,###.#,#,#
 #.#.#,,,#.........#,#.#,,,#.#,#,,,#.#,#O#
 #.#.###,###.#.#####,###,#,###,###,#.#,## 
 #...#,,,#...#.#,,,,,#,,,#,,,,,#,,,#.#,,,#
 #.###,###.#####,#####,## ######,#######,#
 #...#,,,#.....#,#.#..,#,,,,,#..,,,,,,,#,#
  ##.###,###.#.#,#.#.#,#,###,#########,#,#
 #.....#,,,#.#.#,#...#,,,#,,,#,,,#....,,,#
  ########,#.#.#,#########,#.#,#,######## 
 #,,,,,,,,,#.#.#,,,,,,,,,,,#.#,#,,,,,#,,,#
 #,#########.#.#.#############,#####,#,#,#
 #,#.........#.#.#,,,,,,,,,,,#,,,#.#,,,#,#
 #,#########.#.#.#,#########,###,#.#####,#
 #,,,,,,,,,#.#...#,,,,,#.#,,,..#,,,#,,,#,#
  ####.###,#.#########,#.#,#######,#,#,#,#
 #,,,#...#,#.#,,,,,,,,,#.#,#,,,,,,,#,#,,,#
 #,#,#####,###,#######.#.#,#,#######,###.#
 #,#,,,,,#,#,,,#...#S#...#,#,......#,#...#    
 #,#####,#,#,#####.#,###.#,#,#######,###.#   
 #,#...#,#,,,......#,#...#,,,#,,,,,#,,,#.#
 #,###.#,###########,#.#######,###,###,## 
 #,#,,,#,,,#,,,,,,,,,#.#,,,,,,,#.#,,,#,,,#
 #,#,#,###,#,###########,#######.###,#.#,#
 #,#,#,,,#,,,#.#..,,,,,#,#.#.......#,#.#,#
 #,#,###,#####.#.#,###,#,#.#.#.#####,###,#
 #,#,#..,,,,,#...#,,,#,,,#.#.#.....#,,,,,#
 #,#,#######,#######,#####.#.#####.#####.#
 #,#,,,#...#,,,,,,,,,#.....#.#.....#...#.#
 #,###,#.#############.#####.#.###.#.#.#.#
 #,,,,,#...........#.....#...#...#.#.#...#
  ######.#.#########.###.#.## ##.#.#.#### 
 #.#.....#...#.......#.#...#.#...#.#...#.#
 #.#.#### ##.#.#######.#####.#.## ####.#.#
 #.#.#...#...#.......#.....#.#...#.....#.#
 #.#.###.#.#########.###.#.#.###.#.#####.#
 #.......#...............#.....#.........#
  ####### ############### ##### ######### 